F 101,67,33
C 50,50,50

NO textures/wall/wall_N.xpm
SO textures/wall/wall_S.xpm
WE textures/wall/wall_W.xpm
EA textures/wall/wall_E.xpm

11111111111111111111
1BBBOVOBB11BBBBBBBB1
1B000000B11H00000WB1
1B0000000B1B0BBBBBB1
1B0000000HBB000000K1
1BBBCDCBBBBBTB0000K1
1BBB000BBRBRB0000L11
11H00000000000000K11
1BBBBBBBBRBRBBKKL111
11111111111111111111
