F 101,67,33
C 50,50,50

NO textures/wall/wall_N.xpm
SO textures/wall/wall_S.xpm
WE textures/wall/wall_W.xpm
EA textures/wall/wall_E.xpm

11111111111111111111111111111111111111111
1BBBBBBBBBBBBBBBBBBBBBBBBBBBBBBBBBBBBBBB1
1BCCCCCCCCCCCCCCCCCCCCCCBKLKKK0000KKKKKB1
1BBBBBC00000000000000000D00000000000000B1
1BBBBBC0000000000000000CBKKKKK0000LKKKKB1
1BBBBBC0000000000000000CB00000000000000B1
1BBBBBC0000000000000000CBKKLKK0000KKKKLB1
1BBBBBC0000000000000000CB00000000000000B1
1BBBBBC0000000000000000CBKKKLK0000KKKKKB1
1BBBBBC0000000000000000CB00000000000000B1
1BBBBBC0000000000000000CBKLLKK0000KLKKKB1
1BBBBBCCCCCCCCCCCCCCCCCCB00000000000000B1
1BBBBBBBBBBBBBBBBBBBBBBBBBBBBBB0BBBBBBBB1
1BV00000000BRRRRRRRRRRRRRRRRRRR0RRRRRRRB1
1BBBBBBBBB0BRRRRR000000000000000000000RB1
1B000000000BR0000RRRRRRRRRRRRRRRRRR0RRRB1
1B000000000BRRRR000000000000R000RVR0R0RB1
1BBB000BBBBBBBBBB0BRRRRRR0R0R0R0R0R0R0RB1
1B0000000000000000BR000VR0R000R000R000RB1
1H00000000000000BBRR0RRRR0RRRRRRRRR0RRRB1
1B000000000B0000BR00000000000000000000RB1
1BBBBBBBOBBB0000TRRRRRRRRRRRRRRRRRRRRRRR1
1BBBHBBBBBBB0000BBBBBBBBBOBBBBBBBBBBBBBB1
1B0000000000000000000000000000000000000B1
1B000000000BBBB000BBBBBBBBBBBBBBTBBBBB0B1
1B000N00000OBBB000BBBBBBBBBBBBV00000000B1
1BBBBBBBBBBBBBBBHBBBBBBBBBBBBBBBBBBBBBTB1
11111111111111111111111111111111111111111
