F 101,67,33
C 50,50,50

NO textures/wall/wall_N.xpm
SO textures/wall/wall_S.xpm
WE textures/wall/wall_W.xpm
EA textures/wall/wall_E.xpm

1111111111111111111
10W1001001001000001
1011000001000001001
1001001001111101111
1001111000001001001
1000000000000001001
1001111111D11111001
1111000000000001011
1000000001000000001
1111111111111111111
