F textures/bonus/tfloor.xpm
C textures/bonus/tceiling.xpm

NO textures/wall/wall_N.xpm
SO textures/wall/wall_S.xpm
WE textures/wall/wall_W.xpm
EA textures/wall/wall_E.xpm

11111111111111111111
1BOOOVOOOO1BBBBTBBH1
1O0000000O1H00000WB1
1O0000000O1B0BBBBBB1
1O0000000OBB0000LLK1
1BOOCDCOOOBBTB0000K1
1BBB000BBRBRB000LLL1
11H000000000000000K1
1BBBBBBBBRBRBBBLLLB1
11111111111111111111
