F 101,67,33
C 50,50,50

NO textures/wall/wall_N.xpm
SO textures/wall/wall_S.xpm
WE textures/wall/wall_W.xpm
EA textures/wall/wall_E.xpm

1111111111111111111
10010010010010000W1
1000000001000001001
1110000111001111111
1000000010001000001
1000000010000000001
111CDC1111111111001
1000000000000011001
1000000000100000001
1111111111111111111
